0000000000
0011100000
0011111000
0012211000
0112221100
0011111100
0011111000
0001110000
0000100000
0000000000